5,16,Bad,Same,Good 
4,0,9,5,7,6,14,10,13,11,12,1,3,15,2,8,0
15,12,4,1,13,6,14,8,9,10,5,3,11,2,0,7,2
0,1,2,3,4,5,6,7,8,9,10,11,12,13,14,15,1
10,13,8,1,14,0,7,12,2,15,3,9,4,5,6,11,2
9,11,12,1,0,14,13,3,10,7,2,8,5,4,6,15,0
